1111111111111111
101E0000000C0101
101C0000000CP101
1111111111111111
