111111111111
1E0000000C01
1C000X000CP1
111111111111
