11111111111111111111111111111111111111111111111111
1P000000000011111000000000000000000000000000000001
11111100001111110000000011111100001111111110000001
10000100001000000000000010000100001000000001000001
10000111101000000111111111110100111000000001000001
10000000001000000100000000001100001000000001111001
11111000001111111100000000001100001111111111111001
10000100000000000000000000001100000000000000000001
10000111100001111111111000001111111111100000000001
10000000100001000000001000000000000000100000000001
11110000100001000000001000000000000000100000000001
10000000100001111111111000000001111110100000000001
10000000000000000000000000000000000110100000000001
10000000011111111111100001111111110110101111110001
10000000010000000000100001000000000100100000001001
10000000010000000000100001000000000100100000001001
11111100011111111111100001000000000100100000001001
1C000000000000000000000010000000000000000000000001
10000111100001111111111111000001111111111110000001
10000000100001000000000000000001000000000110000001
10000000100001000000000000000001000000000110000001
10000000100001000000000000000001000000000110000001
100000001000010000000000000000010000000001100000E1
10000000100001111111111111111111111111111111111111
11111111111111111111111111111111111111111111111111
