11111111111111111111111111111111
10000100010001000100000000000001
10P00100010101010100C000C000C001
10000100010101010100000000000001
1101110001010101010C000000000C01
10000100010101010100000000000001
1000000001010101E111111000111111
100001000101000111C00000000000C1
10000111000111110001100000001101
1C0C01C1010000000000000000000101
10000101011111110000110001100001
1C0C0101010C0C0100111C000C111001
100001000100000000000000000000C1
11111111111111111111111111111111
