111111111111111111111111111111111
100000100010001000100000000000001
100P00100010101010100C000C000C001
100000100010101010100000000000001
11101110001010101010C000000000C01
100000100010101010100000000000001
10000000001010101E111111000111111
1000001000101000111C00000000000C1
100000111000111110001100000001101
10C0C01C1010000000000000000000101
100000101011111110000110001100001
10C0C0101010C0C0100111C000C111001
1000001000100000000000000000000C1
111111111111111111111111111111111
