11111111
1P0C0CE1
100000C1
11111111
