11111111111111111111111111111111
1CP00C000C000C000C000000C00000E1
11111111111111111111111111111111
