11111111111111111111111111111111
1P000C000C000C000C000000C00000E1
11111111111111111111111111111111
